У	ADP
тех	PRON
кто	PRON
зачем-то	ADVPRO
окончил	VERB
журфак	NOUN
в	ADP
нашем	DET
городе	NOUN
тогда	ADVPRO
было	VERB
три	NUM
пути	NOUN
Можно	PRED
было	VERB
начать	VERB
нигде	ADVPRO
не	PART
работать	VERB
и	CCONJ
беззаботно	ADV
пить	VERB
разбавленное	VERB
тихорецкое	ADJ
стреляя	VERB
по	ADP
сотенке	NOUN
у	ADP
родственников	NOUN
и	CCONJ
знакомых	NOUN
Так	ADVPRO
делало	VERB
большинство	NOUN
Можно	PRED
было	VERB
устроиться	VERB
в	ADP
нашу	DET
крошечную	ADJ
телекомпанию	NOUN
и	CCONJ
пить	VERB
разбавленное	VERB
тихорецкое	ADJ
несколько	ADV
более	ADV
озабоченно	ADV
клепая	VERB
раз	NOUN
в	ADP
день	NOUN
репортажи	NOUN
о	ADP
том	PRON
почему	ADVPRO
новый	ADJ
мэр	NOUN
это	PART
южный	ADJ
Лужков	NOUN
тезис	NOUN
придуманный	VERB
Вовчиком	NOUN
Волиновым	NOUN
мэрским	ADJ
пресс-секом	NOUN
главной	ADJ
заботой	NOUN
которого	DET
было	VERB
не	PART
расплескать	VERB
жирный	ADJ
хаш	NOUN
и	CCONJ
доставить	VERB
его	PRON
ровно	PART
к	ADP
шести	NOUN
в	ADP
гостиницу	NOUN
Интурист	NOUN
чтобы	SCONJ
участники	NOUN
съезда	NOUN
Юга	NOUN
России	NOUN
придуманного	VERB
новым	ADJ
мэром	NOUN
назло	ADV
Москве	NOUN
успели	VERB
опохмелиться	VERB
до	ADP
утреннего	ADJ
заседания	NOUN
Я	PRON
хочу	VERB
быть	VERB
тем	DET
зеркалом	NOUN
для	ADP
сэлфи	NOUN
в	ADP
котором	DET
фоткаются	VERB
красивые	ADJ
и	CCONJ
счастливые	ADJ
подруги	NOUN
сказал	VERB
он	NOUN
свайпя	VERB
ленту	NOUN
инсты	NOUN
Кстати	PARENTH
если	SCONJ
увидели	VERB
к	ADP
тому	DET
моменту	NOUN
я	PRON
так	ADVPRO
отчаялся	VERB
что	SCONJ
попробовал	VERB
как	ADVPRO
зайдёт	VERB
видео	NOUN
где	ADVPRO
я	NOUN
пылесошу	VERB
свои	DET
карманы	NOUN
а	CCONJ
не	PART
читаю	NOUN
книги	NOUN
На	ADP
вид	NOUN
фондюшницы	NOUN
это	PART
компактный	ADJ
корпус	NOUN
с	ADP
подогревом	NOUN
в	ADP
нижней	ADJ
части	NOUN
который	DET
размещается	VERB
на	ADP
подставку	NOUN
Главное	NOUN
в	ADP
хорошем	ADJ
фондю	NOUN
это	PART
правильные	ADJ
продукты	NOUN
Безальтернативность	NOUN
определил	VERB
тот	DET
факт	NOUN
что	SCONJ
на	ADP
два	NUM
тематических	ADJ
тендера	NOUN
МТУСИ	NOUN
никто	PRON
кроме	ADP
НИИ	NOUN
заявок	NOUN
больше	ADV
не	PART
подал	VERB
В	ADP
Питере	NOUN
зумер	NOUN
забегая	VERB
в	ADP
лифт	NOUN
наступил	VERB
дедульке	NOUN
на	VERB
ногу	NOUN
после	ADP
замечания	NOUN
в	ADP
свою	DET
сторону	NOUN
молодой	ADJ
тиктокер	NOUN
не	PART
придумал	VERB
ничего	PRON
лучше	ADJ
как	SCONJ
харкнуть	VERB
старичку	NOUN
в	ADP
лицо	NOUN
но	CCONJ
не	PART
тут-то	PRON
было	VERB
включив	VERB
режим	NOUN
ОЛДСКУЛ	NOUN
дедушка	NOUN
отмудохал	VERB
сиропного	ADJ
полупокера	NOUN
затем	ADV
вытащил	VERB
его	PRON
из	ADP
лифта	NOUN